50 12 2
DDDDDDDDDDDDDDDDDDDDDDDDDDDDDDDDDDDDDDDDDDDDDDDDDD
WWWWWWWWWWWWWWWWWWWWWWWWWWWWWWWWWWWWWWWWWWWWWWWWWW
WFFFFFFFFFFFFFWWWWWWWWWFFFFFFFFFFFWFFFFFFFFFFFFFEW
WFFFFFFFFFFFFFFFFFFFFWWWWWFFFFFFFFWFFFFFFFFFFFFFEW
WFFFFFFFFFFFFFFFFFFFFFFFFFFFFFFFFFWFFFFFFFFFFFFFEW
WFFFFFFFFFFFFFFFFFFFFFFFFFFFFFFFFFWFFFFFFFFFFFFFEW
WFFFFFFFFFFFFFFFFFWWWFFWWWFFFFFFFFWFFFFFFFFFFFFFEW
WFFFFFFFFFFFFFFFFFWWWFFWWWFFFFFFFFWFFFFFFFFFFFFFEW
WFFFFFFFFFFFFFFFFFFFFFFFFFFFFFFFFFFFFFFFFFFFFFFFEW
WFFFFFFFFFFFFFFFFFFFFFFFFFFFFFFFFFFFFFFFFFFFFFFFEW
WFFFFFFFFFFFFFFFFFFFFFFFFFFFFFFFFWWWFFFFWWWFFFFFEW
BBBBBBBBBBBBBBBBBBBBBBBBBBBBBBBBBBBBBBBBBBBBBBBBBB
0 1200 700
1 1300 400