50 12 0
DDDDDDDDDDDDDDDDDDDDDDDDDDDDDDDDDDDDDDDDDDDDDDDDDD
WWWWWWWWWWWWWWWWWWWWWWWWWWWWWWWWWWWWWWWWWWWWWWWWWW
WFFFFFFFFFFFFFFFFFFFFFFFFFFFFFFFFFFFFFFFFFFFFFFFEW
WFFWWWFFFFFFFFFFFFFFFFFFFFFFFFFFFFFFFFFFFFFFFFFFEW
WFWFFFWFFFFFFFFFFFFFFFFFFFFFFFFFFFFFFFFFFFFFFFFFEW
WFFFFFFWFFFFFFFFFFFFFFFFFFFFFFFFFFFFFFFFFFFFFFFFEW
WFFFFFFFWFFFFFFFFFFFFFFFFFFFFFFFFFFFFFFFFFFFFFFFEW
WFFFFFFFFWFFFFFFFFFFFFFFFFFFFFFFFFFFFFFFFFFFFFFFEW
WFFFFWWWWWWWWWFFFFFFFFFFFFFFFFFFFFFFFFFFFFFFFFFFEW
WFFFFFFFFFFFFFFFFFFFFFFFFFFFFFFFFFFFFFFFFFFFFFFFEW
WFFFFFFFFFFFFFFFFFFFFFFFFFFFFFFFFFFFFFFFFFFFFFFFEW
BBBBBBBBBBBBBBBBBBBBBBBBBBBBBBBBBBBBBBBBBBBBBBBBBB
